File name	Artist	Song name
ChhaideuTimi.mid	1974 AD	Chhaideu Timi
DheraiDheraiAauncha.mid	1974 AD	Dherai Dherai Aauncha
JasoGaraJeBhana.mid	1974 AD	Jaso Gara Je Bhana
JungiNishan.mid	1974 AD	Jungi Nishan
MantaMeroNepali.mid	1974 AD	Manta Mero Nepali
Nepali.mid	1974 AD	Nepali
PahiloJunima.mid	1974 AD	Pahilo Junima
Parelima.mid	1974 AD	Parelima
PijadaaKoSuga.mid	1974 AD	Pijadaa Ko Suga
PinjadaKoSuga.mid	1974 AD	Pinjada Ko Suga
Sambhodan.mid	1974 AD	Sambhodan
Sambodhan.mid	1974 AD	Sambodhan
SamjhiBaschhu.mid	1974 AD	Samjhi Baschhu
SaraKhusi.mid	1974 AD	Sara Khusi
SisireJhai.mid	1974 AD	Sisire Jhai
TyoRaatKo.mid	1974 AD	Tyo Raat Ko
TyoRatko.mid	1974 AD	Tyo Ratko
AgeOfAquarius.mid	5th Dimension	Age Of Aquarius
Aquarious.mid	5th Dimension	Aquarious
LastNightIDidntGetToSleepAtAll.mid	5th Dimension	Last Night I Didnt Get To Sleep At All
OneLessBellToAnswere.mid	5th Dimension	One Less Bell To Answere
StonedSoulPicnic.mid	5th Dimension	Stoned Soul Picnic
UpUpAndAway.mid	5th Dimension	Up Up And Away
WeddingBellBlues.mid	5th Dimension	Wedding Bell Blues
BalladForKay.mid	Accoustic Alchemy	Ballad For Kay
NaturalElements.mid	Accoustic Alchemy	Natural Elements
OnTheCase.mid	Accoustic Alchemy	On The Case
PlayingForTime.mid	Accoustic Alchemy	Playing For Time
TheBlueChipBop.mid	Accoustic Alchemy	The Blue Chip Bop
BoogieDown.mid	Al Jarreau	Boogie Down
Moonlighting.mid	Al Jarreau	Moonlighting
Morning.mid	Al Jarreau	Morning
RoofGarden.mid	Al Jarreau	Roof Garden
SinceIFellForYou.mid	Al Jarreau	Since I Fell For You
WereInThisLoveTogether.mid	Al Jarreau	We're In This Love Together
YourSong.mid	Al Jarreau	Your Song
AlJolsonMedley.mid	Al Jolson	Al Jolson Medley
MyMammy.mid	Al Jolson	My Mammy
RockA-ByeMyBaby.mid	Al Jolson	Rock A-Bye My Baby
Swanee.mid	Al Jolson	Swanee
Feelings.mid	Albert Morris	Feelings
AWomansWorth.mid	Alicia Keys	A Womans Worth
Empirestateofmind(partII).mid	Alicia Keys	Empire state of mind (part II)
Fallen.mid	Alicia Keys	Fallen
HowComeYouDontCallAnymore.mid	Alicia Keys	How Come You Don't Call Anymore
IfIAintGotYou.mid	Alicia Keys	If I Ain't Got You
Karma.mid	Alicia Keys	Karma
NeverFeltThisWay.mid	Alicia Keys	Never Felt This Way
YouDontKnowMyName.mid	Alicia Keys	You Don't Know My Name
5To10.mid	Allan Holdsworth	5 To 10
Atavachron.mid	Allan Holdsworth	Atavachron
BlueTango.mid	Amanda Lear	Blue Tango
BackToBlack.mid	Amy Winehouse	Back To Black
LoveIsALosingGame.mid	Amy Winehouse	Love Is A Losing Game
Rehab.mid	Amy Winehouse	Rehab
Valerie.mid	Amy Winehouse	Valerie
YouKnowImNoGood.mid	Amy Winehouse	You Know Im No Good
ATimeForUs.mid	Andy Williams	A Time For Us
CantGetUsedToLosingYou.mid	Andy Williams	Cant Get Used To Losing You
Exodus.mid	Andy Williams	Exodus
ImpossibleDream.mid	Andy Williams	Impossible Dream
LoveStory.mid	Andy Williams	Love Story
Moonriver.mid	Andy Williams	Moonriver
More.mid	Andy Williams	More
SomewhereMyLove.mid	Andy Williams	Somewhere My Love
TheImpossibleDream.mid	Andy Williams	The Impossible Dream
TheSummerKnows.mid	Andy Williams	The Summer Knows
ThereWillNeverBeAnotherYou.mid	Andy Williams	There Will Never Be Another You
WalkOnBy.mid	Andy Williams	Walk On By
GoodEnough.mid	Anita Baker	Good Enough
JustBecause.mid	Anita Baker	Just Because
NoOneInTheWorld.mid	Anita Baker	No One In The World
RaptureofLove.mid	Anita Baker	Rapture of Love
SweetLove.mid	Anita Baker	Sweet Love
AtLast.mid	Aretha Franklin	At Last
ChainOfFools.mid	Aretha Franklin	Chain Of Fools
PinkCadillac.mid	Aretha Franklin	Pink Cadillac
Respect.mid	Aretha Franklin	Respect
Think.mid	Aretha Franklin	Think
YouMakeMeFeelLike.mid	Aretha Franklin	You Make Me Feel Like
AKindOfTherapy.mid	Bad Logic	A Kind Of Therapy
BadGirlDolly.mid	Bad Logic	Bad Girl Dolly
ClearAsTheDark.mid	Bad Logic	Clear As The Dark
Dying.mid	Bad Logic	Dying
HearOnMyOwn.mid	Bad Logic	Hear On My Own
InLoveAgain.mid	Bad Logic	In Love Again
InMyWay.mid	Bad Logic	In My Way
JustAGame.mid	Bad Logic	Just A Game
LovinAllNightLong.mid	Bad Logic	Lovin All Night Long
TheresOnlyOneWayToRock.mid	Bad Logic	Theres Only One Way To Rock
AllIAskOfYou.mid	Barbra Streisand	All I Ask Of You
BeforeThePardadePassesMeBy.mid	Barbra Streisand	Before The Pardade Passes Me By
DontRainOnMyParade.mid	Barbra Streisand	Dont Rain On My Parade
Evergreen.mid	Barbra Streisand	Evergreen
Guilty.mid	Barbra Streisand	Guilty
HappyDaysAreHereAgain.mid	Barbra Streisand	Happy Days Are Here Again
HelloDolly.mid	Barbra Streisand	Hello Dolly
IveNeverBeenInLoveBefore.mid	Barbra Streisand	Ive Never Been In Love Before
LAigleNoir.mid	Barbra Streisand	L Aigle Noir
LuckBeALady.mid	Barbra Streisand	Luck Be A Lady
Memory.mid	Barbra Streisand	Memory
NyStateOfMind.mid	Barbra Streisand	Ny State Of Mind
OverTheRainbow.mid	Barbra Streisand	Over The Rainbow
People.mid	Barbra Streisand	People
SinceIDontHaveYou.mid	Barbra Streisand	Since I Dont Have You
Somewhere.mid	Barbra Streisand	Somewhere
StoneyEnd.mid	Barbra Streisand	Stoney End
TellHim.mid	Barbra Streisand	Tell Him
TheWayWeWere.mid	Barbra Streisand	The Way We Were
UnePetiteCantate.mid	Barbra Streisand	Une Petite Cantate
WhatAKindOfFool.mid	Barbra Streisand	What A Kind Of Fool
WhereYouLead.mid	Barbra Streisand	Where You Lead
WomanInLove.mid	Barbra Streisand	Woman In Love
YouDontBringMeFlowers.mid	Barbra Streisand	You Dont Bring Me Flowers
FlyMetotheMoon.mid	Bart Howard	Fly Me to the Moon
Allthethingsyouare.mid	Bill Evans	All the things you are
AutumnLeaves.mid	Bill Evans	Autumn Leaves
GodBlessTheChild.mid	Blood Sweat And Tears	God Bless The Child
SpinningWheel.mid	Blood Sweat And Tears	Spinning Wheel
YouveMadeMeSoVeryHappy.mid	Blood Sweat And Tears	Youve Made Me So Very Happy
GoingBackHome.mid	Bob Gaynor	Going Back Home
MellowHombre.mid	Bob Gaynor	Mellow Hombre
NewPhunk.mid	Bob Gaynor	New Phunk
NewStLeu.mid	Bob Gaynor	New St Leu
SirJoe.mid	Bob Gaynor	Sir Joe
Angela.mid	Bob James	Angela
CleanSweep.mid	Bobby Broom	Clean Sweep
MoBetterBlues.mid	Branford Marsalis	Mo Better Blues
JumpJiveAndWail.mid	Brian Setzer Orchestra	Jump Jive And Wail
AnotherDay.mid	Bruce Hornsby	Another Day
BuglersDream.mid	Bruce Hornsby	Bugler's Dream
ChinaDoll.mid	Bruce Hornsby	China Doll
CountryDoctor.mid	Bruce Hornsby	Country Doctor
CruiseControl.mid	Bruce Hornsby	Cruise Control
EndoftheInnocence.mid	Bruce Hornsby	End of the Innocence
EveryLittleKiss.mid	Bruce Hornsby	Every Little Kiss
FireontheCross.mid	Bruce Hornsby	Fire on the Cross
HarborLights.mid	Bruce Hornsby	Harbor Lights
LongRace.mid	Bruce Hornsby	Long Race
LookOutAnyWindow.mid	Bruce Hornsby	Look Out Any Window
MandolinRain.mid	Bruce Hornsby	Mandolin Rain
OldPlayground.mid	Bruce Hornsby	Old Playground
PassingThrough.mid	Bruce Hornsby	Passing Through
RestingPlace.mid	Bruce Hornsby	Resting Place
RiverRunsLow.mid	Bruce Hornsby	River Runs Low
ShowGoesOn.mid	Bruce Hornsby	Show Goes On
SpiderFingers.mid	Bruce Hornsby	Spider Fingers
StanderontheMountain.mid	Bruce Hornsby	Stander on the Mountain
TalkoftheTown.mid	Bruce Hornsby	Talk of the Town
TheWayItIs.mid	Bruce Hornsby	The Way It Is
WalkintheSun.mid	Bruce Hornsby	Walk in the Sun
Aquabot.mid	Buckethead	Aquabot
BigSurMoon.mid	Buckethead	Big Sur Moon
BingeAndGrab.mid	Buckethead	Binge And Grab
ChickenFeed.mid	Buckethead	Chicken Feed
EnterTheDragon.mid	Buckethead	Enter The Dragon
GiantRobotLesson.mid	Buckethead	Giant Robot Lesson
HogBitchStomp.mid	Buckethead	Hog Bitch Stomp
I-5Binge.mid	Buckethead	I-5 Binge
JumpMan.mid	Buckethead	Jump Man
KillerFlaminBuddy.mid	Buckethead	Killer Flamin Buddy
NightOfTheSlunk.mid	Buckethead	Night Of The Slunk
NumbNubs.mid	Buckethead	Numb Nubs
PeepShowBinge.mid	Buckethead	Peep Show Binge
PowerRangersTheme.mid	Buckethead	Power Rangers Theme
RevengeWedge.mid	Buckethead	Revenge Wedge
ScoopFromTheCoop.mid	Buckethead	Scoop From The Coop
SomewhereOverTheSlaughterhouse.mid	Buckethead	Somewhere Over The Slaughterhouse
TaxidermyLoaf.mid	Buckethead	Taxidermy Loaf
WelcomeToBucketheadland.mid	Buckethead	Welcome To Bucketheadland
Whitewash.mid	Buckethead	Whitewash
LilyWasHere.mid	Candy Dulfer	Lily Was Here
Saxy.mid	Candy Dulfer	Saxy
Asayake.mid	Casiopea	Asayake
ContinentalWay.mid	Casiopea	Continental Way
Dazzling.mid	Casiopea	Dazzling
EyesOfMind.mid	Casiopea	Eyes Of Mind
Lakai.mid	Casiopea	Lakai
LookingUp.mid	Casiopea	Looking Up
Swear.mid	Casiopea	Swear
BeautifulGirl.mid	Charlie Rich	Beautiful Girl
BehindClosedDoors.mid	Charlie Rich	Behind Closed Doors
ILoveMyFriends.mid	Charlie Rich	I Love My Friends
Shecalledmebaby.mid	Charlie Rich	She called me baby
ALittleBitofBlues.mid	Chet Atkins	A Little Bit of Blues
ALittleMarkMusic.mid	Chet Atkins	A Little Mark Music
Aintchagottired.mid	Chet Atkins	Aint cha got tired
AllIEverNeedIsYou.mid	Chet Atkins	All I Ever Need Is You
AllThumb.mid	Chet Atkins	All Thumb
Amazinggrace.mid	Chet Atkins	Amazing grace
AngelEyes.mid	Chet Atkins	Angel Eyes
AutumnLeaves(LesFeuillesMortes).mid	Chet Atkins	Autumn Leaves (LesFeuilles Mortes)
Avalon.mid	Chet Atkins	Avalon
BackhomeagaininIndiana.mid	Chet Atkins	Back home again in Indiana
BirthOfTheBlues.mid	Chet Atkins	Birth Of The Blues
BlackMountainRag.mid	Chet Atkins	Black Mountain Rag
BlueAngel.mid	Chet Atkins	Blue Angel
Blueocean.mid	Chet Atkins	Blue ocean
BothSidesNow.mid	Chet Atkins	Both Sides Now
CannedHeat.mid	Chet Atkins	Canned Heat
Caravan.mid	Chet Atkins	Caravan
Cascade.mid	Chet Atkins	Cascade
Charade.mid	Chet Atkins	Charade
Cheektocheek.mid	Chet Atkins	Cheek to cheek
Chinatawn.mid	Chet Atkins	Chinatawn
CindyOhCindy.mid	Chet Atkins	Cindy Oh Cindy
CityofNewOrleans.mid	Chet Atkins	City of New Orleans
ClassicalGas.mid	Chet Atkins	Classical Gas
CopperKettle.mid	Chet Atkins	Copper Kettle
CosmicSquareDance.mid	Chet Atkins	Cosmic Square Dance
DizzyFingers.mid	Chet Atkins	Dizzy Fingers
DriveIn.mid	Chet Atkins	Drive In
Entertainer.mid	Chet Atkins	Entertainer
FreightTrain.mid	Chet Atkins	Freight Train
HelloMyBaby.mid	Chet Atkins	Hello My Baby
IllSaySheDoes.mid	Chet Atkins	I ll Say She Does
IfIHadYou.mid	Chet Atkins	If I Had You
IllSeeYouInMyDreams.mid	Chet Atkins	Ill See You In My Dreams
Imagine.mid	Chet Atkins	Imagine
JerrysBreakdown.mid	Chet Atkins	Jerrys Breakdown
LesFeuillesMortes.mid	Chet Atkins	Les Feuilles Mortes
MainStreetBreakdown.mid	Chet Atkins	Main Street Breakdown
ManhaDeCarnaval.mid	Chet Atkins	Manha De Carnaval
Maybelle.mid	Chet Atkins	Maybelle
MisterSandman.mid	Chet Atkins	Mister Sandman
MisterSandman(2).mid	Chet Atkins	Mister Sandman (2)
MrBojangles.mid	Chet Atkins	Mr Bojangles
MusictoWatchGirlsby.mid	Chet Atkins	Music to Watch Girls by
NutSundae.mid	Chet Atkins	Nut Sundae
OchiChornya.mid	Chet Atkins	Ochi Chornya
OhByJingoOhByGee.mid	Chet Atkins	Oh By Jingo Oh By Gee
OneMintJulep.mid	Chet Atkins	One Mint Julep
OverTheWaves.mid	Chet Atkins	Over The Waves
RockyTop.mid	Chet Atkins	Rocky Top
SaltyDog.mid	Chet Atkins	Salty Dog
SilentNight.mid	Chet Atkins	Silent Night
SilentNight(2).mid	Chet Atkins	Silent Night (2)
StLouisBlues.mid	Chet Atkins	St Louis Blues
Struttin.mid	Chet Atkins	Struttin
TakeFive.mid	Chet Atkins	Take Five
TheLastFarewell.mid	Chet Atkins	The Last Farewell
TigerRag.mid	Chet Atkins	Tiger Rag
Trambone.mid	Chet Atkins	Trambone
Vincent.mid	Chet Atkins	Vincent
WabashCannonBall.mid	Chet Atkins	Wabash Cannon Ball
Wheels.mid	Chet Atkins	Wheels
Wheels(2).mid	Chet Atkins	Wheels (2)
Whispering.mid	Chet Atkins	Whispering
WildWoodFlower.mid	Chet Atkins	Wild Wood Flower
WindyAndWarm.mid	Chet Atkins	Windy And Warm
Wobegon.mid	Chet Atkins	Wobegon
YaketyAxe.mid	Chet Atkins	Yakety Axe
YaketyAxe(2).mid	Chet Atkins	Yakety Axe (2)
YaketyAxe(3).mid	Chet Atkins	Yakety Axe (3)
YankeeDoodleDixie.mid	Chet Atkins	Yankee Doodle Dixie
Yesterday.mid	Chet Atkins	Yesterday
YoureGonnaBeSorry.mid	Chet Atkins	Youre Gonna Be Sorry
ZorbaTheGreek.mid	Chet Atkins	Zorba The Greek
CentralParkWest.mid	Chick Corea	Central Park West
ChipBlue.mid	Chick Corea	Chip Blue
CitygateRumble.mid	Chick Corea	Citygate Rumble
LightYear.mid	Chick Corea	Light Year
RomanticWarrior.mid	Chick Corea	Romantic Warrior
Rumble.mid	Chick Corea	Rumble
Sidewalk.mid	Chick Corea	Sidewalk
Spain.mid	Chick Corea	Spain
TwoKids.mid	Chick Corea	Two Kids
Imsorry.mid	Connie Francis	I'm sorry
StupidCupid.mid	Connie Francis	Stupid Cupid
WhosSorryNow.mid	Connie Francis	Who's Sorry Now
CountOnTheBlues.mid	Count Basie	Count On The Blues
Emily.mid	Dave Koz	Emily
PieceOfMyWish.mid	Dave Koz	Piece Of My Wish
YouMakeMeSmile.mid	Dave Koz	You Make Me Smile
FreedomAtMidnight.mid	David Benoit	Freedom At Midnight
SatinDoll.mid	Duke Ellington	Satin Doll
St.LouisBlues.mid	Duke Ellington	St.Louis Blues
TaketheAtrain.mid	Duke Ellington	Take the A train
AfterTheLoveHasGone.mid	Earth Wind And Fire	After The Love Has Gone
BoogieWonderland.mid	Earth Wind And Fire	Boogie Wonderland
Fantasy.mid	Earth Wind And Fire	Fantasy
GotToGetYouIntoMyLife.mid	Earth Wind And Fire	Got To Get You Into My Life
LetsGrooveTonight.mid	Earth Wind And Fire	Lets Groove Tonight
September.mid	Earth Wind And Fire	September
ShiningStar.mid	Earth Wind And Fire	Shining Star
SingASong.mid	Earth Wind And Fire	Sing A Song
SundayMorning.mid	Earth Wind And Fire	Sunday Morning
ThatsTheWayoftheWorld.mid	Earth Wind And Fire	Thats The Way of the World
DontDreamOfAnybodyButMe.mid	Ella Fitzgerald	Dont Dream Of Anybody But Me
DreamaLittleDreamofMe.mid	Ella Fitzgerald	Dream a Little Dream of Me
HowHighTheMoon.mid	Ella Fitzgerald	How High The Moon
ICantGiveYouAnythingButLove.mid	Ella Fitzgerald	I Cant Give You Anything But Love
NightAndDay.mid	Ella Fitzgerald	Night And Day
SomeoneToWatchOverMe.mid	Ella Fitzgerald	Someone To Watch Over Me
Summertime.mid	Ella Fitzgerald	Summertime
Misty.mid	Erroll Garner	Misty
AtLast.mid	Etta James	At Last
DanceWithMeHenry.mid	Etta James	Dance With Me Henry
IdRatherGoBlind.mid	Etta James	Id Rather Go Blind
Criminal.mid	Fiona Apple	Criminal
Shadowboxer.mid	Fiona Apple	Shadowboxer
SleepToDream.mid	Fiona Apple	Sleep To Dream
AintNoWomanLikeTheOneIGot.mid	Four Tops	Aint No Woman Like The One I Got
BabyINeedYourLovin.mid	Four Tops	Baby I Need Your Lovin
Bernadette.mid	Four Tops	Bernadette
CantHelpMyself.mid	Four Tops	Cant Help Myself
DontWalkAwayInTheMusic.mid	Four Tops	Dont Walk Away In The Music
IfIWereACarpenter,IfIHadAHammer.mid	Four Tops	If I Were A Carpenter, If I Had A Hammer
LocoInAcapulco1.mid	Four Tops	Loco In Acapulco 1
LocoInAcapulco2.mid	Four Tops	Loco In Acapulco 2
ReachOut.mid	Four Tops	Reach Out
SameOldSong.mid	Four Tops	Same Old Song
SameOldSong(2).mid	Four Tops	Same Old Song (2)
StandingInTheShadowOfLove.mid	Four Tops	Standing In The Shadow Of Love
WalkAwayRenee.mid	Four Tops	Walk Away Renee
WorkingMyWayBackToYou.mid	Four Tops	Working My Way Back To You
Adayinalifeofafool.mid	Frank Sinatra	A day in a life of a fool
AllMyTomorrows.mid	Frank Sinatra	All My Tomorrows
AllOfMe.mid	Frank Sinatra	All Of Me
AllofYou.mid	Frank Sinatra	All of You
AllOrNothingAtAll.mid	Frank Sinatra	All Or Nothing At All
AllTheThingsYouAre.mid	Frank Sinatra	All The Things You Are
AllTheWay.mid	Frank Sinatra	All The Way
AngelEyes.mid	Frank Sinatra	Angel Eyes
AprilinParis.mid	Frank Sinatra	April in Paris
AutumninNewYork.mid	Frank Sinatra	Autumn in New York
AutumnLeaves.mid	Frank Sinatra	Autumn Leaves
Bewitched.mid	Frank Sinatra	Bewitched
BlueRoom.mid	Frank Sinatra	Blue Room
BreezeAndI.mid	Frank Sinatra	Breeze And I
ButBeautiful.mid	Frank Sinatra	But Beautiful
ButNotForMe.mid	Frank Sinatra	But Not For Me
Cestmagnifique.mid	Frank Sinatra	C'est magnifique
CheekToCheek.mid	Frank Sinatra	Cheek To Cheek
CloseToYou.mid	Frank Sinatra	Close To You
DancingOnTheCeiling.mid	Frank Sinatra	Dancing On The Ceiling
DarnThatDream.mid	Frank Sinatra	Darn That Dream
DontTakeYourLoveFromMe.mid	Frank Sinatra	Don't Take Your Love From Me
EastoftheSun.mid	Frank Sinatra	East of the Sun
EasyToLove.mid	Frank Sinatra	Easy To Love
EbbTide.mid	Frank Sinatra	Ebb Tide
FlyMeToTheMoon.mid	Frank Sinatra	Fly Me To The Moon
FoggyDayinLondonTown.mid	Frank Sinatra	Foggy Day in London Town
FoolsRushIn.mid	Frank Sinatra	Fools Rush In
ForHeavensSake.mid	Frank Sinatra	For Heaven's Sake
GettinSentimentalOverYou.mid	Frank Sinatra	Gettin Sentimental Over You
GhostOfaChance.mid	Frank Sinatra	Ghost Of a Chance
GirlFromIpanema.mid	Frank Sinatra	Girl From Ipanema
HeresThatRainyDayAgain.mid	Frank Sinatra	Here's That Rainy Day Again
HowDoYouKeepTheMusicPlaying.mid	Frank Sinatra	How Do You Keep The Music Playing
HowHighTheMoon.mid	Frank Sinatra	How High The Moon
IBelieve.mid	Frank Sinatra	I Believe
IConcentrateOnYou.mid	Frank Sinatra	I Concentrate On You
IGetaKickOutOfYou.mid	Frank Sinatra	I Get a Kick Out Of You
IShouldCare.mid	Frank Sinatra	I Should Care
Iwontdance.mid	Frank Sinatra	I won't dance
IllBeSeeingYou.mid	Frank Sinatra	I'll Be Seeing You
IllGetBy.mid	Frank Sinatra	I'll Get By
IllNeverSmileAgain.mid	Frank Sinatra	I'll Never Smile Again
ImAFoolToWantYou.mid	Frank Sinatra	I'm A Fool To Want You
ImGettingSentimentalOverYou.mid	Frank Sinatra	I'm Getting Sentimental Over You
IveGotaCrushOnYou.mid	Frank Sinatra	I've Got a Crush On You
IveHeardThatSongBefore.mid	Frank Sinatra	I've Heard That Song Before
IllTakeManhattan.mid	Frank Sinatra	Ill Take Manhattan
ImAFoolToWantYou.mid	Frank Sinatra	Im A Fool To Want You
Invitation.mid	Frank Sinatra	Invitation
ItHadToBeYou.mid	Frank Sinatra	It Had To Be You
ItWasAVeryGoodYear.mid	Frank Sinatra	It Was A Very Good Year
ItsOnlyAPaperMoon.mid	Frank Sinatra	Its Only A Paper Moon
IveGotTheWorldOnAString.mid	Frank Sinatra	Ive Got The World On A String
IveGotYouUnderMySkin.mid	Frank Sinatra	Ive Got You Under My Skin
Ladyisatramp.mid	Frank Sinatra	Lady is a tramp
Laura.mid	Frank Sinatra	Laura
Letmetryagain.mid	Frank Sinatra	Let me try again
LetMeTryAgain(2).mid	Frank Sinatra	Let Me Try Again (2)
LoveandMarriage.mid	Frank Sinatra	Love and Marriage
LuckBeALady.mid	Frank Sinatra	Luck Be A Lady
MakinWhoopie.mid	Frank Sinatra	Makin Whoopie
Manhattan.mid	Frank Sinatra	Manhattan
MoonlightinVermont.mid	Frank Sinatra	Moonlight in Vermont
More.mid	Frank Sinatra	More
MoreThanYouKnow.mid	Frank Sinatra	More Than You Know
MyFunnyValentine.mid	Frank Sinatra	My Funny Valentine
MyOldFlame.mid	Frank Sinatra	My Old Flame
MyPrayer.mid	Frank Sinatra	My Prayer
MyWay.mid	Frank Sinatra	My Way
Nancy.mid	Frank Sinatra	Nancy
NearnessOfYou.mid	Frank Sinatra	Nearness Of You
NewYorkNewYork.mid	Frank Sinatra	New York New York
NicenEasy.mid	Frank Sinatra	Nicen Easy
NightandDay.mid	Frank Sinatra	Night and Day
OnaClearDay.mid	Frank Sinatra	On a Clear Day
OneForMyBaby.mid	Frank Sinatra	One For My Baby
OurLoveIsHereToStay.mid	Frank Sinatra	Our Love Is Here To Stay
PolkaDotsandMoonbeans.mid	Frank Sinatra	Polka Dots and Moonbeans
RedSailsInTheSunset.mid	Frank Sinatra	Red Sails In The Sunset
SalutetoNelsonRiddle.mid	Frank Sinatra	Salute to Nelson Riddle
SeptemberSong.mid	Frank Sinatra	September Song
ShesFunnyThatWay.mid	Frank Sinatra	She's Funny That Way
SmokeGetsInYourEyes.mid	Frank Sinatra	Smoke Gets In Your Eyes
SomethingStupid.mid	Frank Sinatra	Something Stupid
SongIsYou.mid	Frank Sinatra	Song Is You
Stardust.mid	Frank Sinatra	Stardust
StrangersInTheNight.mid	Frank Sinatra	Strangers In The Night
SummerWind.mid	Frank Sinatra	Summer Wind
SweetGeorgia.mid	Frank Sinatra	Sweet Georgia
ThatOldFeeling.mid	Frank Sinatra	That Old Feeling
ThatsLife.mid	Frank Sinatra	That's Life
TheresaSmallHotel.mid	Frank Sinatra	There's a Small Hotel
TwoSleepyPeople.mid	Frank Sinatra	Two Sleepy People
Unforgettable.mid	Frank Sinatra	Unforgettable
WayYouLookTonight.mid	Frank Sinatra	Way You Look Tonight
WhatKindOfFoolAmI.mid	Frank Sinatra	What Kind Of Fool Am I
WhatsNew.mid	Frank Sinatra	What's New
WhenYourLoverHasGone.mid	Frank Sinatra	When Your Lover Has Gone
WhereorWhen.mid	Frank Sinatra	Where or When
WhoCanITurnTo.mid	Frank Sinatra	Who Can I Turn To
WillowWeepForMe.mid	Frank Sinatra	Willow Weep For Me
Witchcraft.mid	Frank Sinatra	Witchcraft
Yesterdays.mid	Frank Sinatra	Yesterdays
YouAreTooBeautiful.mid	Frank Sinatra	You Are Too Beautiful
YouDontKnowWhatLoveIs.mid	Frank Sinatra	You Don't Know What Love Is
YouGoToMyHead.mid	Frank Sinatra	You Go To My Head
YoureNobodyTillSomebodyLovesYou.mid	Frank Sinatra	You're Nobody 'Till Somebody Loves You
YouveChanged.mid	Frank Sinatra	You've Changed
YoungAtHeart.mid	Frank Sinatra	Young At Heart
YoursIsMyHeartAlone.mid	Frank Sinatra	Yours Is My Heart Alone
2ndMovementOfSinisterFootwear.mid	Frank Zappa	2nd Movement Of Sinister Footwear
ABC.mid	Frank Zappa	ABC
Alphonso.mid	Frank Zappa	Alphonso
Andy.mid	Frank Zappa	Andy
Apostrophe.mid	Frank Zappa	Apostrophe
Bebop.mid	Frank Zappa	Bebop
Berlin.mid	Frank Zappa	Berlin
BlackPage.mid	Frank Zappa	Black Page
Blows.mid	Frank Zappa	Blows
BobbyBrown.mid	Frank Zappa	Bobby Brown
BrownShoesDontMakeIt.mid	Frank Zappa	Brown Shoes Dont Make It
DirtyLove.mid	Frank Zappa	Dirty Love
DontEatTheYellowSnow.mid	Frank Zappa	Dont Eat The Yellow Snow
EchidnasArf(OfYou).mid	Frank Zappa	Echidnas Arf (Of You)
FatherOblivion.mid	Frank Zappa	Father Oblivion
Flakes.mid	Frank Zappa	Flakes
HungryFreaksDaddy.mid	Frank Zappa	Hungry Freaks Daddy
KingKongItself.mid	Frank Zappa	King Kong Itself
LetsMakeTheWaterTurnBlack.mid	Frank Zappa	Lets Make The Water Turn Black
Montana.mid	Frank Zappa	Montana
MuffinMan.mid	Frank Zappa	Muffin Man
MyGuitarWantsToKillYourMama.mid	Frank Zappa	My Guitar Wants To Kill Your Mama
NanookRubsIt.mid	Frank Zappa	Nanook Rubs It
NanookSuite.mid	Frank Zappa	Nanook Suite
PackardGoose.mid	Frank Zappa	Packard Goose
PeachesInRegalia.mid	Frank Zappa	Peaches In Regalia
ShutUpNPlayYerGuitarSomeMore.mid	Frank Zappa	Shut Up N Play Yer Guitar Some More
SleepDirt(BlackNapkins).mid	Frank Zappa	Sleep Dirt (Black Napkins)
StAlfonzosPancakeBreakfast.mid	Frank Zappa	St Alfonzos Pancake Breakfast
TheDeathlessHorsie.mid	Frank Zappa	The Deathless Horsie
ThemeFromLumpyGravy.mid	Frank Zappa	Theme From Lumpy Gravy
TroubleEveryDay.mid	Frank Zappa	Trouble Every Day
TwentySmallCigars.mid	Frank Zappa	Twenty Small Cigars
UncleMeat.mid	Frank Zappa	Uncle Meat
UncleRemus.mid	Frank Zappa	Uncle Remus
WatermelonInEasterHay.mid	Frank Zappa	Watermelon In Easter Hay
WatermelonInEasterHay(2).mid	Frank Zappa	Watermelon In Easter Hay (2)
WeddingDressSong.mid	Frank Zappa	Wedding Dress Song
WhatsNewInBaltimore.mid	Frank Zappa	Whats New In Baltimore
WillieThePimp.mid	Frank Zappa	Willie The Pimp
ZootAllures.mid	Frank Zappa	Zoot Allures
BandofGold.mid	Freda Payne	Band of Gold
SweetAboutMe.mid	Gabriella Cilmi	Sweet About Me
Dreams.mid	Gabrielle	Dreams
GabbyDance.mid	Gabrielle	Gabby Dance
OutOfReach.mid	Gabrielle	Out Of Reach
Rise.mid	Gabrielle	Rise
ShouldIStay,ShouldIGo.mid	Gabrielle	Should I Stay, Should I Go
Sunshine.mid	Gabrielle	Sunshine
WhenAWoman.mid	Gabrielle	When A Woman
CityOfGoldLicks.mid	Gary Moore	City Of Gold Licks
ColdDayInHell.mid	Gary Moore	Cold Day In Hell
EmptyRooms.mid	Gary Moore	Empty Rooms
FridayOnMyMind.mid	Gary Moore	Friday On My Mind
MidnightBlue.mid	Gary Moore	Midnight Blue
OneDay.mid	Gary Moore	One Day
OneDay(2).mid	Gary Moore	One Day (2)
ParisienneWalkways.mid	Gary Moore	Parisienne Walkways
ParisienneWalkways(2).mid	Gary Moore	Parisienne Walkways (2)
PrettyWoman.mid	Gary Moore	Pretty Woman
SeparateWays.mid	Gary Moore	Separate Ways
StillGotTheBlues.mid	Gary Moore	Still Got The Blues
StoryOfTheBlues.mid	Gary Moore	Story Of The Blues
TheLoner.mid	Gary Moore	The Loner
TooTired.mid	Gary Moore	Too Tired
WalkinByMyself.mid	Gary Moore	Walkin By Myself
Breezin.mid	George Benson	Breezin
GiveMeTheNight.mid	George Benson	Give Me The Night
MakeLove.mid	George Benson	Make Love
NothingGonnaChangeMyLove.mid	George Benson	Nothing Gonna Change My Love
OnBroadway.mid	George Benson	On Broadway
ThisMasquerade.mid	George Benson	This Masquerade
TurnYourLoveAround.mid	George Benson	Turn Your Love Around
ACrush.mid	Hank Jones	A Crush
Adventage.mid	Hank Jones	Adventage
Bluesette.mid	Hank Jones	Bluesette
ICantGetStarted.mid.mid	Hank Jones	I Cant Get Started.mid
IndianSummer.mid	Hank Jones	Indian Summer
LookAtMe.mid	Hank Jones	Look At Me
OhLadyBeGood.mid	Hank Jones	Oh Lady Be Good
RecordaMe.mid	Hank Jones	Recorda Me
RoundMidnight.mid	Hank Jones	Round Midnight
SatinDoll.mid	Hank Jones	Satin Doll
SecretLove.mid	Hank Jones	Secret Love
SentimentalMood.mid	Hank Jones	Sentimental Mood
TheShadowofYourSmile.mid	Hank Jones	The Shadow of Your Smile
TheyCantTakeAwayFromMe.mid	Hank Jones	They Cant Take Away From Me
WhereOrWhen.mid	Hank Jones	Where Or When
YouGoToMyHead.mid	Hank Jones	You Go To My Head
Chameleon.mid	Herbie Hancock	Chameleon
Funkytown.mid	Herbie Hancock	Funkytown
LittleSunflower.mid	Herbie Hancock	Little Sunflower
RockIt.mid	Herbie Hancock	Rock It
TheTrailor.mid	Herbie Hancock	The Trailor
WatermelonMan.mid	Herbie Hancock	Watermelon Man
Vehicle.mid	Ides of March	Vehicle
AnimateInanimate.mid	John Petrucci	Animate Inanimate
Barfbag.mid	John Petrucci	Barfbag
BiteOfTheMosquito.mid	John Petrucci	Bite Of The Mosquito
Bumblebee.mid	John Petrucci	Bumblebee
Curve.mid	John Petrucci	Curve
DamageControl.mid	John Petrucci	Damage Control
EtudeInAMinorOpus10No2.mid	John Petrucci	Etude In A Minor Opus 10 No 2
Exercise.mid	John Petrucci	Exercise
Gemini.mid	John Petrucci	Gemini
GlasgowKiss.mid	John Petrucci	Glasgow Kiss
GlasgowKiss(Live).mid	John Petrucci	Glasgow Kiss (Live)
HollowYears.mid	John Petrucci	Hollow Years
InsidePicking.mid	John Petrucci	Inside Picking
IntroMusic(FromRockDiscipline).mid	John Petrucci	Intro Music (From Rock Discipline)
JawsOfLife.mid	John Petrucci	Jaws Of Life
LeftHandWarmUp.mid	John Petrucci	Left Hand Warm Up
LostWithoutYou.mid	John Petrucci	Lost Without You
MysticDreamExercise.mid	John Petrucci	Mystic Dream Exercise
Necrominicon(Epilogue).mid	John Petrucci	Necrominicon (Epilogue)
Petrucciesque.mid	John Petrucci	Petrucciesque
RockDiscipline.mid	John Petrucci	Rock Discipline
SpeedAndTechnique.mid	John Petrucci	Speed And Technique
Tarantelle.mid	John Petrucci	Tarantelle
TheLegatoTechnique.mid	John Petrucci	The Legato Technique
TunnelVision.mid	John Petrucci	Tunnel Vision
WishfulThinking.mid	John Petrucci	Wishful Thinking
Emily.mid	Johnny Mandel	Emily
SuicideIsPainless.mid	Johnny Mandel	Suicide Is Painless
SuicideIsPainless(2).mid	Johnny Mandel	Suicide Is Painless (2)
TheShadowOfYourSmile.mid	Johnny Mandel	The Shadow Of Your Smile
ACertainSmile.mid	Johnny Mathis	A Certain Smile
ChancesAre.mid	Johnny Mathis	Chances Are
ItsNotforMeToSay.mid	Johnny Mathis	It's Not for Me To Say
WonderfulWonderful.mid	Johnny Mathis	Wonderful Wonderful
BigYellowTaxi.mid	Joni Mitchell	Big Yellow Taxi
BothSidesNow.mid	Joni Mitchell	Both Sides Now
HelpMe.mid	Joni Mitchell	Help Me
OpenArms.mid	Joni Mitchell	Open Arms
River.mid	Joni Mitchell	River
Woodstock.mid	Joni Mitchell	Woodstock
AnyWayYouWantIt.mid	Journey	Any Way You Want It
BeGoodToYourself.mid	Journey	Be Good To Yourself
CantTameTheLion.mid	Journey	Cant Tame The Lion
Daydream.mid	Journey	Daydream
DontStopBelievin.mid	Journey	Dont Stop Believin
Faithfully.mid	Journey	Faithfully
Faithfully2.mid	Journey	Faithfully 2
FeelingThatWay.mid	Journey	Feeling That Way
GirlCantHelpIt.mid	Journey	Girl Cant Help It
IllBeAlrightWithoutYou.mid	Journey	Ill Be Alright Without You
JustTheSameWay.mid	Journey	Just The Same Way
Lights.mid	Journey	Lights
LovinTouchinSqueezin.mid	Journey	Lovin Touchin Squeezin
MessageOfLove.mid	Journey	Message Of Love
Mother,Father.mid	Journey	Mother, Father
OhSherrie.mid	Journey	Oh Sherrie
OnlyTheYoung.mid	Journey	Only The Young
OpenArms.mid	Journey	Open Arms
OpenedTheDoor.mid	Journey	Opened The Door
SendHerMyLove.mid	Journey	Send Her My Love
SeparateWays.mid	Journey	Separate Ways
SeparateWays2.mid	Journey	Separate Ways 2
StayAwhile.mid	Journey	Stay Awhile
StoneInLove.mid	Journey	Stone In Love
SweetAndSimple.mid	Journey	Sweet And Simple
ThePartysOver.mid	Journey	The Partys Over
TooLate.mid	Journey	Too Late
WheelintheSky.mid	Journey	Wheel in the Sky
WhenYouLoveAWoman.mid	Journey	When You Love A Woman
WhenYoureAloneItAintEasy.mid	Journey	When Youre Alone It Aint Easy
WhiterShadeOfPale.mid	Journey	Whiter Shade Of Pale
WhosCryinNow.mid	Journey	Whos Cryin Now
WhosCryingNow2.mid	Journey	Whos Crying Now 2
WhyCantThisNightGoOnForever.mid	Journey	Why Cant This Night Go On Forever
Alone.mid	Kenny G	Alone
Breathless.mid	Kenny G	Breathless
ByMySide.mid	Kenny G	By My Side
DyingYoung.mid	Kenny G	Dying Young
ForeverInLove.mid	Kenny G	Forever In Love
GoingHome.mid	Kenny G	Going Home
InTheRain.mid	Kenny G	In The Rain
JoyofLife.mid	Kenny G	Joy of Life
Moment.mid	Kenny G	Moment
Morning.mid	Kenny G	Morning
Sentimental.mid	Kenny G	Sentimental
Silhouette.mid	Kenny G	Silhouette
Songbird.mid	Kenny G	Songbird
UncleAl.mid	Kenny G	Uncle Al
Celebration.mid	Kool & The Gang	Celebration
Cherish.mid	Kool & The Gang	Cherish
Fresh.mid	Kool & The Gang	Fresh
GetDownOnIt.mid	Kool & The Gang	Get Down On It
JoAnna.mid	Kool & The Gang	Jo Anna
JungleBoogie.mid	Kool & The Gang	Jungle Boogie
LadiesNight.mid	Kool & The Gang	Ladies Night
TooHot.mid	Kool & The Gang	Too Hot
BukasNaLangKitaMamahalin.mid	Lani Misalucha	Bukas Na Lang Kita Mamahalin
TunayNaMahal.mid	Lani Misalucha	Tunay Na Mahal
DolphinDreams.mid	Lee Ritenour	Dolphin Dreams
EarlyA.M.Attitude.mid	Lee Ritenour	Early A.M. Attitude
FlyByNight.mid	Lee Ritenour	Fly By Night
Foreplay.mid	Lee Ritenour	Foreplay
JustAnotherDay.mid	Lee Ritenour	Just Another Day
RioFunk.mid	Lee Ritenour	Rio Funk
SugarloafExpress.mid	Lee Ritenour	Sugarloaf Express
AllOverYou.mid	Level 42	All Over You
BitterMoon.mid	Level 42	Bitter Moon
ChildrenSay.mid	Level 42	Children Say
DuneTune.mid	Level 42	Dune Tune
Guaranteed.mid	Level 42	Guaranteed
HotWater.mid	Level 42	Hot Water
ItsOver.mid	Level 42	Its Over
LeavingMeNow.mid	Level 42	Leaving Me Now
LessonsInLove.mid	Level 42	Lessons In Love
LoveGame.mid	Level 42	Love Game
LoveInAPeacefulWorld.mid	Level 42	Love In A Peaceful World
MyFathersShoes.mid	Level 42	My Fathers Shoes
RunningInTheFamily.mid	Level 42	Running In The Family
Silence.mid	Level 42	Silence
SomethingAboutYou.mid	Level 42	Something About You
StandingInTheLight.mid	Level 42	Standing In The Light
Starchild.mid	Level 42	Starchild
TakeALook.mid	Level 42	Take A Look
TheSunGoesDown.mid	Level 42	The Sun Goes Down
ToBeWithYouAgain.mid	Level 42	To Be With You Again
Tracie.mid	Level 42	Tracie
WorldMachine.mid	Level 42	World Machine
AllMyLife.mid	Linda Ronstadt	All My Life
BlueBayou.mid	Linda Ronstadt	Blue Bayou
Differentdums.mid	Linda Ronstadt	Different dums
DontknowMuch.mid	Linda Ronstadt	Don't know Much
FeelsLikeHome.mid	Linda Ronstadt	Feels Like Home
HurtSoBad.mid	Linda Ronstadt	Hurt So Bad
ItssoeasytofallinLove.mid	Linda Ronstadt	It's so easy to fall in Love
JustOneKiss.mid	Linda Ronstadt	Just One Kiss
SomewhereOutThere.mid	Linda Ronstadt	Somewhere Out There
Thatllbetheday.mid	Linda Ronstadt	That'll be the day
WhenWillIBeLoved.mid	Linda Ronstadt	When Will I Be Loved
YoureNoGood.mid	Linda Ronstadt	Youre No Good
914.mid	Liquid Tension Experiment	914
AcidRain.mid	Liquid Tension Experiment	Acid Rain
AnotherDimension.mid	Liquid Tension Experiment	Another Dimension
Biaxident.mid	Liquid Tension Experiment	Biaxident
FreedoomOfSpeech.mid	Liquid Tension Experiment	Freedoom Of Speech
Hourglass.mid	Liquid Tension Experiment	Hourglass
KindredSpirits.mid	Liquid Tension Experiment	Kindred Spirits
ParadigmShift.mid	Liquid Tension Experiment	Paradigm Shift
StateOfGrace.mid	Liquid Tension Experiment	State Of Grace
UniversalMind.mid	Liquid Tension Experiment	Universal Mind
WhenTheWaterBreaks.mid	Liquid Tension Experiment	When The Water Breaks
FineBrownFrame.mid	Lou Rawls	Fine Brown Frame
LadyLove.mid	Lou Rawls	Lady Love
SeeYouWhenIGetThere.mid	Lou Rawls	See You When I Get There
YoullNeverFindAnotherLoveLikeMine.mid	Lou Rawls	Youll Never Find Another Love Like Mine
BlueberryHill.mid	Louis Armstrong	Blueberry Hill
Cabaret.mid	Louis Armstrong	Cabaret
HelloDolly.mid	Louis Armstrong	Hello Dolly
KissOfFire.mid	Louis Armstrong	Kiss Of Fire
MuskratRamble.mid	Louis Armstrong	Muskrat Ramble
OneDayYoullBeSorry.mid	Louis Armstrong	One Day Youll Be Sorry
TheManILove.mid	Louis Armstrong	The Man I Love
TheyCantTakeThatAwayFromMe.mid	Louis Armstrong	They Cant Take That Away From Me
WhenTheSaintsGoMarchingIn.mid	Louis Armstrong	When The Saints Go Marching In
WonderfulWorld.mid	Louis Armstrong	Wonderful World
Marie-Mai-Encoreunenuit.mid	Marie Mai	Marie-Mai - Encore une nuit
Marie-Mai-Tutenfous.mid	Marie Mai	Marie-Mai - Tu t'en fous
634-5789.mid	Marvin Gaye	634-5789
AintNothingLikeRealThingBaby.mid	Marvin Gaye	Aint Nothing Like Real Thing Baby
CharliePuth.mid	Marvin Gaye	Charlie Puth
HeardItThroughTheGrapevine.mid	Marvin Gaye	Heard It Through The Grapevine
HowSweetItIsToBeLovedByYou.mid	Marvin Gaye	How Sweet It Is To Be Loved By You
IllBeDoggone.mid	Marvin Gaye	Ill Be Doggone
InnerCityBlues.mid	Marvin Gaye	Inner City Blues
MercyMercyMe.mid	Marvin Gaye	Mercy Mercy Me
SexualHealing.mid	Marvin Gaye	Sexual Healing
StandByMe.mid	Marvin Gaye	Stand By Me
StandByMe(2).mid	Marvin Gaye	Stand By Me (2)
StopLookListenToYourHeart.mid	Marvin Gaye	Stop Look Listen To Your Heart
WhatsGoinOn.mid	Marvin Gaye	Whats Goin On
YoureAllINeedToGetBy.mid	Marvin Gaye	Youre All I Need To Get By
Afoggydayilondontown.mid	Michael Buble	A foggy day i londontown
AllIDoIsDreamOfYou.mid	Michael Buble	All I Do Is Dream Of You
comeflywithme.mid	Michael Buble	come fly with me
Crazylittlethingcalllove.mid	Michael Buble	Crazy little thing call love
DreamALittleDream.mid	Michael Buble	Dream A Little Dream
Everything.mid	Michael Buble	Everything
FilingGood.mid	Michael Buble	Filing Good
Foronceinmylife.mid	Michael Buble	For once in my life
Haventmetyouyet.mid	Michael Buble	Havent met you yet
HoldOn.mid	Michael Buble	Hold On
Hollywood.mid	Michael Buble	Hollywood
Home.mid	Michael Buble	Home
Howcanyoumendabrokenheart.mid	Michael Buble	How can you mend a broken heart
Kissingafool.mid	Michael Buble	Kissing a fool
MackTheKnife.mid	Michael Buble	Mack The Knife
Moondance.mid	Michael Buble	Moondance
MyFunnyValentine.mid	Michael Buble	My Funny Valentine
PutYourHandOnMyShoulder.mid	Michael Buble	Put Your Hand On My Shoulder
Quando,Quando,Quando.mid	Michael Buble	Quando, Quando, Quando
SavetheLastDanceforme.mid	Michael Buble	Save the Last Dance for me
Spiderman.mid	Michael Buble	Spiderman
Summerwind.mid	Michael Buble	Summerwind
Sway.mid	Michael Buble	Sway
ThatsAll.mid	Michael Buble	Thats All
TheWayYouLookTonight.mid	Michael Buble	The Way You Look Tonight
TryALittleTenderness.mid	Michael Buble	Try A Little Tenderness
YouDontKnowMe.mid	Michael Buble	You Dont Know Me
Youllneverfind.mid	Michael Buble	Youll never find
onceuponatimeinspace.mid	Michel Legrand	once upon a time in space
55Dive.mid	Mike Stern	55 Dive
Chromazone.mid	Mike Stern	Chromazone
HahaHotel.mid	Mike Stern	Haha Hotel
AllBlues.mid	Miles Davis	All Blues
AloneTogether.mid	Miles Davis	Alone Together
BigTime.mid	Miles Davis	Big Time
BlueInGreen.mid	Miles Davis	Blue In Green
Bluette.mid	Miles Davis	Bluette
Decoy.mid	Miles Davis	Decoy
EightyOne.mid	Miles Davis	Eighty One
Four.mid	Miles Davis	Four
Joshua.mid	Miles Davis	Joshua
Milestones.mid	Miles Davis	Milestones
Nardis.mid	Miles Davis	Nardis
SevenStepstoHeaven.mid	Miles Davis	Seven Steps to Heaven
SoWhat.mid	Miles Davis	So what
Solar.mid	Miles Davis	Solar
TuneUp.mid	Miles Davis	Tune Up
Tutu.mid	Miles Davis	Tutu
BangBang(MyBabyShotMeDown).mid	Nancy Sinatra	Bang Bang (My Baby Shot Me Down)
SummerWine.mid	Nancy Sinatra	Summer Wine
TheseBootsWereMadeForWalking.mid	Nancy Sinatra	These Boots Were Made For Walking
AroundTheWorld.mid	Nat King Cole	Around The World
CachitoMioChacha.mid	Nat King Cole	Cachito Mio Chacha
Love.mid	Nat King Cole	Love
MonaLisa.mid	Nat King Cole	Mona Lisa
ThatsAllGreatAmericanSongbook.mid	Nat King Cole	Thats All Great American Songbook
Unforgettable.mid	Nat King Cole	Unforgettable
YoullNeverKnow.mid	Nat King Cole	Youll Never Know
GoodMorningHeartache.mid	Natalie Cole	Good Morning Heartache
ILiveForYourLove.mid	Natalie Cole	I Live For Your Love
Love.mid	Natalie Cole	Love
MissYouLikeCrazy.mid	Natalie Cole	Miss You Like Crazy
MrMelody.mid	Natalie Cole	Mr Melody
OrangeColoredSky.mid	Natalie Cole	Orange Colored Sky
PinkCadalac.mid	Natalie Cole	Pink Cadalac
SomeoneThatIUsedToLove.mid	Natalie Cole	Someone That I Used To Love
Unforgettable.mid	Natalie Cole	Unforgettable
BetterDaysAhead.mid	Pat Metheny	Better Days Ahead
EverySummerNight.mid	Pat Metheny	Every Summer Night
James.mid	Pat Metheny	James
Lakes.mid	Pat Metheny	Lakes
PhaseDance.mid	Pat Metheny	Phase Dance
SongForBilao.mid	Pat Metheny	Song For Bilao
AllBehindUsNow.mid	Patti Austin	All Behind Us Now
BabyComeToMe.mid	Patti Austin	Baby Come To Me
InMyLife.mid	Patti Austin	In My Life
ItMightBeYou.mid	Patti Austin	It Might Be You
CrazyLove.mid	Paul Anka	Crazy Love
DayanaEspaÃ±olversion.mid	Paul Anka	Dayana Español version
Diana.mid	Paul Anka	Diana
Dreamlover.mid	Paul Anka	Dreamlover
LonelyBoy(ImJustA).mid	Paul Anka	Lonely Boy (Im Just A)
PuppyLove.mid	Paul Anka	Puppy Love
PutYourHeadOnMyShoulder.mid	Paul Anka	Put Your Head On My Shoulder
YouAreMyDestiny.mid	Paul Anka	You Are My Destiny
ALittleIsEnough.mid	Pete Townshend	A Little Is Enough
BrilliantBlues.mid	Pete Townshend	Brilliant Blues
FaceDancesPart2.mid	Pete Townshend	Face Dances Part 2
GiveBlood.mid	Pete Townshend	Give Blood
LetMyLoveOpenTheDoor.mid	Pete Townshend	Let My Love Open The Door
PureAndEasy.mid	Pete Townshend	Pure And Easy
RoughBoys.mid	Pete Townshend	Rough Boys
AffairInSanMiguel.mid	Rippingtons	Affair In San Miguel
Aspen.mid	Rippingtons	Aspen
AvenidaDelMar.mid	Rippingtons	Avenida Del Mar
BigSky.mid	Rippingtons	Big Sky
BlackDiamond.mid	Rippingtons	Black Diamond
BraveNewWorld.mid	Rippingtons	Brave New World
CurvesAhead.mid	Rippingtons	Curves Ahead
Destiny.mid	Rippingtons	Destiny
DreamOfSirens.mid	Rippingtons	Dream Of Sirens
HideAway.mid	Rippingtons	Hide Away
IndianSummer.mid	Rippingtons	Indian Summer
JamaicanNights.mid	Rippingtons	Jamaican Nights
Kilimanjaro.mid	Rippingtons	Kilimanjaro
Moonlighting.mid	Rippingtons	Moonlighting
Mordance.mid	Rippingtons	Mordance
Morocco.mid	Rippingtons	Morocco
MovingViolation.mid	Rippingtons	Moving Violation
NativeSonsOfADistantLand.mid	Rippingtons	Native Sons Of A Distant Land
OneSummerNightInBrasil.mid	Rippingtons	One Summer Night In Brasil
RoadWarriors.mid	Rippingtons	Road Warriors
SoulMates.mid	Rippingtons	Soul Mates
StTropez.mid	Rippingtons	St Tropez
StoriesOfThePaintedDesert.mid	Rippingtons	Stories Of The Painted Desert
ThePrincess.mid	Rippingtons	The Princess
TouristInParadise.mid	Rippingtons	Tourist In Paradise
VirtualReality.mid	Rippingtons	Virtual Reality
WednesdaysChild.mid	Rippingtons	Wednesdays Child
WelcomeToTheStJamesClub.mid	Rippingtons	Welcome To The St James Club
WhatSheReallyWants.mid	Rippingtons	What She Really Wants
Children.mid	Robert Miles	Children
Fable.mid	Robert Miles	Fable
InTheDawn.mid	Robert Miles	In The Dawn
OneAndOne.mid	Robert Miles	One And One
KillingMeSoftly.mid	Roberta Flack	Killing Me Softly
MakingLove.mid	Roberta Flack	Making Love
TheCloserIGetToYou.mid	Roberta Flack	The Closer I Get To You
TonightICelebrateMyLove.mid	Roberta Flack	Tonight I Celebrate My Love
WhereIsTheLove.mid	Roberta Flack	Where Is The Love
BibonoAozora.mid	Ryuichi Sakamoto	Bibo no Aozora
Koko.mid	Ryuichi Sakamoto	Koko
MerryChristmasMr.Lawrence.mid	Ryuichi Sakamoto	Merry Christmas Mr.Lawrence
Riderideride.mid	Ryuichi Sakamoto	Ride ride ride
ShelteringSky.mid	Ryuichi Sakamoto	Sheltering Sky
ByYourSide.mid	Sade	By Your Side
CherishTheDay.mid	Sade	Cherish The Day
CherryPie.mid	Sade	Cherry Pie
GiveItUp.mid	Sade	Give It Up
HanginInYourLove.mid	Sade	Hangin In Your Love
KeepLooking(ver1).mid	Sade	Keep Looking (ver 1)
KeepLooking(ver2).mid	Sade	Keep Looking (ver 2)
KissofLife.mid	Sade	Kiss of Life
LoveIsStrongerThanPride.mid	Sade	Love Is Stronger Than Pride
NoOrdinaryLove.mid	Sade	No Ordinary Love
NothingCanComeBetweenUs.mid	Sade	Nothing Can Come Between Us
OrdinaryLove.mid	Sade	Ordinary Love
Paradise.mid	Sade	Paradise
SiempreHayEsperanza.mid	Sade	Siempre Hay Esperanza
SmoothOperator.mid	Sade	Smooth Operator
SweetestTaboo.mid	Sade	Sweetest Taboo
WhyCantWeLiveTogether.mid	Sade	Why Cant We Live Together
YourLoveIsKing.mid	Sade	Your Love Is King
Aja.mid	Steely Dan	Aja
BabylonSisters.mid	Steely Dan	Babylon Sisters
BlackFriday.mid	Steely Dan	Black Friday
Bodhisattva.mid	Steely Dan	Bodhisattva
DaddyDontLiveInThatNewYorkCityNoMore.mid	Steely Dan	Daddy Dont Live In That New York City No More
DeaconBlues.mid	Steely Dan	Deacon Blues
DoItAgain.mid	Steely Dan	Do It Again
EastSt.LouisToodleOh.mid	Steely Dan	East St. Louis Toodle Oh
FM.mid	Steely Dan	FM
GoodbyeLook.mid	Steely Dan	Good bye Look
HeyNineteen.mid	Steely Dan	Hey Nineteen
HomeAtLast.mid	Steely Dan	Home At Last
IGY.mid	Steely Dan	IGY
Josie.mid	Steely Dan	Josie
KidCharlemagne.mid	Steely Dan	Kid Charlemagne
Maxine.mid	Steely Dan	Maxine
MyOldSchool.mid	Steely Dan	My Old School
NewFrontier.mid	Steely Dan	New Frontier
Nightfly.mid	Steely Dan	Nightfly
Peg.mid	Steely Dan	Peg
PretzalLogic.mid	Steely Dan	Pretzal Logic
ReelingInTheYears.mid	Steely Dan	Reeling In The Years
RikkiDontLoseThatNumber.mid	Steely Dan	Rikki Dont Lose That Number
RikkiDontLoseThatNumber(2).mid	Steely Dan	Rikki Dont Lose That Number (2)
RubyBaby.mid	Steely Dan	Ruby Baby
RubyTuesday.mid	Steely Dan	Ruby Tuesday
WalkBetweentheRaindrops.mid	Steely Dan	Walk Between the Raindrops
BoogieOnRaggaeWomen.mid	Stevie Wonder	Boogie On Raggae Women
DontYouWorryAboutaThing.mid	Stevie Wonder	Don't You Worry About a Thing
Ebony&Ivory.mid	Stevie Wonder	Ebony & Ivory
ForOnceinMyLife.mid	Stevie Wonder	For Once in My Life
GoldenLady.mid	Stevie Wonder	Golden Lady
HappyBirthday.mid	Stevie Wonder	Happy Birthday
HeavenHelpUsAll.mid	Stevie Wonder	Heaven Help Us All
HesMisstraKnow-it-all.mid	Stevie Wonder	Hes Misstra Know-it-all
HigherGround.mid	Stevie Wonder	Higher Ground
IJustCalledtoSayILoveYou.mid	Stevie Wonder	I Just Called to Say I Love You
IWish.mid	Stevie Wonder	I Wish
IsntSheLovely.mid	Stevie Wonder	Isn't She Lovely
KnocksMeOffMyFeet.mid	Stevie Wonder	Knocks Me Off My Feet
Masquerade.mid	Stevie Wonder	Masquerade
MasterBlaster.mid	Stevie Wonder	Master Blaster
MyCherieAmour.mid	Stevie Wonder	My Cherie Amour
Overjoy.mid	Stevie Wonder	Overjoy
PartTimeLover.mid	Stevie Wonder	Part Time Lover
RibbonInTheSky.mid	Stevie Wonder	Ribbon In The Sky
SignedSealedDelivered.mid	Stevie Wonder	Signed Sealed Delivered
Signed,Sealed,Delivered(ImYours).mid	Stevie Wonder	Signed, Sealed, Delivered (Im Yours)
SirDuke.mid	Stevie Wonder	Sir Duke
Superstitions.mid	Stevie Wonder	Superstitions
ThatsWhatFriendsAreFor.mid	Stevie Wonder	Thats What Friends Are For
UptightEverythingsAlright.mid	Stevie Wonder	Uptight Everything's Alright
WhereItsAt.mid	Stevie Wonder	Where It's At
YouAreTheSunshineOfMyLife.mid	Stevie Wonder	You Are The Sunshine Of My Life
YouAreTheSunshineOfMyLife(2).mid	Stevie Wonder	You Are The Sunshine Of My Life (2)
AThousandYears.mid	Sting	A Thousand Years
AfterTheRainHasFallen.mid	Sting	After The Rain Has Fallen
AllFourSeasons.mid	Sting	All Four Seasons
AllThisTime.mid	Sting	All This Time
BeStillMyBeatingHeart.mid	Sting	Be Still My Beating Heart
BeneathADesertMoon.mid	Sting	Beneath A Desert Moon
BrandNewDay.mid	Sting	Brand New Day
ConsiderMeGone.mid	Sting	Consider Me Gone
DeadMansRope.mid	Sting	Dead Mans Rope
DesertRose.mid	Sting	Desert Rose
EndOfTheGame.mid	Sting	End Of The Game
EnglishManInNewYork.mid	Sting	English Man In New York
Epilogue.mid	Sting	Epilogue
EveryBreatheYouTake.mid	Sting	Every Breathe You Take
FieldsOfGold.mid	Sting	Fields Of Gold
FillHerUp.mid	Sting	Fill Her Up
FortressAroundYourHeart.mid	Sting	Fortress Around Your Heart
Fragile.mid	Sting	Fragile
GhostStory.mid	Sting	Ghost Story
HeavyCloudsNoRain.mid	Sting	Heavy Clouds No Rain
IHungMyHead.mid	Sting	I Hung My Head
IWasBroughtToMySenses.mid	Sting	I Was Brought To My Senses
IfIEverLoseMyFaithInYou.mid	Sting	If I Ever Lose My Faith In You
IfYouLoveSomebodySetThemFree.mid	Sting	If You Love Somebody Set Them Free
ImSoHappyICantStopCrying.mid	Sting	Im So Happy I Cant Stop Crying
Inside.mid	Sting	Inside
IslandOfSouls.mid	Sting	Island Of Souls
ItsProbablyMe.mid	Sting	Its Probably Me
LaBelleDameSansRegrets.mid	Sting	La Belle Dame Sans Regrets
LetYourSoulBeYourPilot.mid	Sting	Let Your Soul Be Your Pilot
LithiumSunset.mid	Sting	Lithium Sunset
LittleWing.mid	Sting	Little Wing
LoveIsStrongerThanJustice.mid	Sting	Love Is Stronger Than Justice
LoveIsTheSeventhWave.mid	Sting	Love Is The Seventh Wave
MadAboutYou.mid	Sting	Mad About You
MoonOverBourbonStreet.mid	Sting	Moon Over Bourbon Street
NeverComingHome.mid	Sting	Never Coming Home
NothingBoutMe.mid	Sting	Nothing Bout Me
Russians.mid	Sting	Russians
SaintAgnesandTheBlessingTrain.mid	Sting	Saint Agnes and The Blessing Train
SaintAugustine.mid	Sting	Saint Augustine
SecondMarriage.mid	Sting	Second Marriage
SendYourLove.mid	Sting	Send Your Love
SevenDays.mid	Sting	Seven Days
ShapeOfMyHeart.mid	Sting	Shape Of My Heart
ShesTooGoodForMe.mid	Sting	Shes Too Good For Me
SisterMoon.mid	Sting	Sister Moon
Someonetowatchoverme.mid	Sting	Someone to watch over me
SomethingTheBoySaid.mid	Sting	Something The Boy Said
SoulCages.mid	Sting	Soul Cages
StolenCar(TakeMeDancing).mid	Sting	Stolen Car (Take Me Dancing)
StraightToMyHeart.mid	Sting	Straight To My Heart
TheHoundsOfWinter.mid	Sting	The Hounds Of Winter
TheSecretMariage.mid	Sting	The Secret Mariage
TheWildWildSea.mid	Sting	The Wild Wild Sea
TheyDanceAlone.mid	Sting	They Dance Alone
ThisCowboySong.mid	Sting	This Cowboy Song
TwentyFiveToMidnight.mid	Sting	Twenty Five To Midnight
Valparaiso.mid	Sting	Valparaiso
WeWorkTheBlackSeam.mid	Sting	We Work The Black Seam
WellBeTogether.mid	Sting	We'll Be Together
WhenWeDance.mid	Sting	When We Dance
WheneverISayYourName.mid	Sting	Whenever I Say Your Name
WhyShouldICryForYou.mid	Sting	Why Should I Cry For You
YouStillTouchMe.mid	Sting	You Still Touch Me
Music!Music!Music!.mid	Teresa Brewer	Music! Music! Music!
ItsAllIntheGame.mid	Tommy Edwards	It's All In the Game
LoveIsAllWeNeed.mid	Tommy Edwards	Love Is All We Need
CantilopeIsland.mid	US3	Cantilope Island
BrownEyedGirl.mid	Van Morrison	Brown Eyed Girl
Domino.mid	Van Morrison	Domino
IntotheMystic.mid	Van Morrison	Into the Mystic
Moondance.mid	Van Morrison	Moondance
WildNights.mid	Van Morrison	Wild Nights
ColorsOfTheWind.mid	Vanessa Williams	Colors Of The Wind
SaveTheBestForLast.mid	Vanessa Williams	Save The Best For Last
WhatsAWoman.mid	Vaya Con Dios	What's A Woman
Peanuts.mid	Vince Guaraldi	Peanuts
AFifthofBeethoven.mid	Walter Murphy	A Fifth of Beethoven
ARemarkYouMade.mid	Weather Report	A Remark You Made
BirdLand.mid	Weather Report	Bird Land
BlackMarket.mid	Weather Report	Black Market
ElegantPeople.mid	Weather Report	Elegant People
Havona.mid	Weather Report	Havona
Paladium.mid	Weather Report	Paladium
Phantasm.mid	Weather Report	Phantasm
PictureOfYou.mid	Weather Report	Picture Of You
Pinocchio.mid	Weather Report	Pinocchio
Rawhide.mid	Weather Report	Rawhide
Teentown.mid	Weather Report	Teentown
HowYaDoDat.mid	Young Blood	How Ya Do Dat
